[移動]
列	先頭	0
	先頭の空白以外	^
	末尾	$
単語	次	w
	前	b	※単語の途中ならその単語
	次の末尾	e	※単語の途中ならその単語
	前の末尾	ge
文	次	)
	前	(
段落	次	}
	前	{
シンボル	対	%
検索	次の文字	f{char}
	繰り返し	;
	戻る	,
	次の単語	/単語
	前の単語	?単語
	繰り返し	n
	戻る	N
行	指定行	数G

[モード]
挿入	前	i
	後	a
	先頭	I
	末尾	A
	削除＋挿入	c

[編集]
削除	d

[選択]
テキストオブジェクト	インナーテキスト	i区切り文字	始/終どちらでもいい
								ビジュアルモードやモーション部分に使う
			アウターテキスト	a区切り文字
			単語	iw
			単語 + 空白	dw
