項目	操作	備考

BIOS	設定  ＞  更新とセキュリティ  ＞  回復  ＞  今すぐ再起動する  ＞
	トラブルシューティング  ＞  詳細オプション  ＞
	UEFIファームウェアの設定  ＞ 再起動
パスワード入力なし		ファイル名を指名して実行  ＞  netplwiz
パスワードをPINにする	設定  ＞  アカウント  ＞サインインオプション


パーティションの設定	スタートを右クリック  ＞  ディスク管理
HDDのフルバックアップと起動ディスクの作成	コントロールパネル  ＞  システムとセキュリティ  ＞  バックアップと復元  ＞  システムイメージの作成 ＆ システム修復ディスクの作成
起動USBの作成		コルタナ検索  ＞  回復ドライブ


既定のプログラム	設定  ＞  アプリ  ＞  既定のアプリ
起動時に開くファイル	ファイル名を指名して実行  ＞  shell:startup  クイックアクセスにピン止め済み
送る先を設定		shell:sendto  ＞  開いたフォルダにアプリをドラッグ	フォルダも可能	クイックアクセスにピン止め済み
保存先を別ドライブに変更		設定  ＞  システム  ＞ ストレージ  ＞
	新しいコンテンツの保存先を変更する
よくアクセスするページを表示しない	設定  ＞  個人用設定  ＞  スタート
不要ファイルの自動削除	設定  ＞  システム  ＞  ストレージ  ＞  ストレージセンサー


【パフォーマンス】
高速スタートアップ	コントロールパネル  ＞  システムとセキュリティ  ＞
	電源オプション  ＞  電源ボタンの動作の変更  ＞
	現在利用可能でない設定を変更します
自動起動するアプリを停止	設定  ＞  プライバシー  ＞  バックグラウンドアプリ
スワップ領域の容量を固定	エクスプローラー  ＞  PCを右クリック  ＞
	プロパティ ＞  システムの詳細設定  ＞  詳細設定  ＞  パフォーマンス  ＞  設定  ＞  詳細設定  ＞  仮想メモリ  ＞  変更
視覚効果をオフ	エクスプローラー  ＞  PCを右クリック  ＞
	プロパティ  ＞  システムの詳細設定  ＞  詳細設定  ＞
	パフォーマンス  ＞	設定  ＞  視覚効果  ＞  パフォーマンスを優先する
半透明表示をオフ	設定  ＞  個人用設定  ＞  色  ＞  視覚効果
デバイスの自動再生をオフ	設定  ＞  デバイス  ＞  自動再生
ポップアップヒントをオフ	エクスプローラー  ＞  表示  ＞  オプション  ＞
	表示  ＞  詳細設定  ＞  フォルダーとデスクトップの項目の説明をポップアップで表示する


【起動と停止】
シャットダウン	Shift + シャットダウン	※通常のシャットダウンはハイバネートなのでBIOS画面が出ない
休止を表示	コントロールパネル  ＞  システムとセキュリティ  ＞
	電源オプション  ＞  電源ボタンの動作の変更  ＞
	現在利用可能でない設定を変更します


【操作】
複数のデスクトップ		タスクビュー  ＞  新しいデスクトップ
	ショートカットキー		タスクビュー		Windows + Tab
					移動		Windows + Ctrl + ←/
→
ファイルを指定したアプリで開く	Shift + ドラッグ  ＞  アイコン


【健康】
ブルーライトカット	設定  ＞  システム  ＞  ディスプレイ  ＞  夜間モード設定


【パフォーマンス・チェック】
タスクマネージャー	Ctrl + Shift + Esc
メモリの使用状況	タスクマネージャー  ＞  パフォーマンス  ＞  メモリ  ＞
	リソースのモニタを開く
